111111111111111111111111
1____22____1_____22____1
1__________1___________1
1______________________1
1__________1___________1
1__________1_____222_222
1__________1_____2_____2
1____22____1111112_____2
1____22____1111112_____2
1__________1_____2_____2
1__________1_____222_222
1__________1___________1
1______________________1
1__________1___________1
1____22____1_____22____1
111111111111111111111111
