333333333333333333333333
3______________________3
3______________________3
3______________________3
3__________3___________3
3__________3___________3
3__________3___________3
3__________3___________3
3______________________3
3__________3___________3
3__________3___________3
3______________________3
3______________________3
3______________________3
3______________________3
333333333333333333333333
