333333333333333333333333
3______________________3
3______________________3
3______________________3
3____44____44____44____3
3____44____44____44____3
3______________________3
3______________________3
3______________________3
3______________________3
3____44____44____44____3
3____44____44____44____3
3______________________3
3______________________3
3______________________3
333333333333333333333333
